0;0;0;0;0;0;0;0;0;1;0;0;0;
0;2;1;2;0;2;1;2;0;2;1;2;0;
0;0;0;0;0;0;0;0;0;1;1;1;0;
0;2;0;2;0;2;1;2;0;2;1;2;0;
0;0;1;0;0;0;1;0;0;0;0;0;0;
0;2;1;2;0;2;1;2;1;2;0;2;0;
0;0;1;1;0;0;0;0;1;0;1;0;0;
0;2;0;2;0;2;0;2;1;2;0;2;0;
0;0;0;0;0;0;0;0;1;0;0;0;0;
0;2;0;2;1;2;1;2;0;2;0;2;0;
0;0;0;0;1;1;1;0;0;0;0;0;0;
#0_Sable\1.jpg
#1_Bois\6.jpg
#2_Pierre\5.jpg
#Name_collision_testing
