0;0;1;1;1;0;1;1;1;0;0;0;0;
0;2;1;2;1;2;1;2;1;2;0;2;0;
0;0;1;1;1;1;1;1;1;1;0;0;0;
0;2;1;2;0;2;1;2;1;2;0;2;0;
0;0;1;1;1;0;1;0;1;1;1;0;0;
0;2;1;2;1;2;0;2;1;2;0;2;0;
0;1;1;1;1;1;0;1;1;1;1;0;0;
0;2;1;2;1;2;0;2;1;2;1;2;0;
0;1;1;1;1;1;1;1;1;1;1;1;0;
0;2;1;2;1;2;1;2;1;2;1;2;0;
0;0;1;1;1;1;1;1;0;1;1;0;0;
#0_Bois\1.jpg
#1_Bois\4.jpg
#2_Metal\1.jpg
#Name_MAP_OF_TEH_HARDCODER
