0;0;1;1;1;1;1;1;1;1;1;0;0;
0;2;1;2;1;2;1;2;1;2;1;2;0;
1;1;1;1;1;1;1;1;1;0;1;1;1;
1;2;0;2;1;2;1;2;0;2;1;2;1;
0;0;0;1;1;0;0;0;0;0;1;1;1;
0;2;1;2;0;2;0;2;0;2;1;2;1;
1;1;1;0;0;0;0;0;0;0;1;1;1;
1;2;1;2;0;2;0;2;0;2;1;2;1;
1;1;1;1;0;0;0;0;0;0;1;1;1;
0;2;1;2;0;2;0;2;0;2;1;2;0;
0;0;1;1;1;1;1;1;0;1;1;0;0;
#0_Pierre\3.jpg
#1_Bois\2.jpg
#2_Terre\1.jpg
#Name_map2
